08,08,09,09,09,21,21,21,09,09,09,09,09,09,09,09,09,09,09,09,09,09,09,08,08
08,08,21,21,21,21,21,21,21,21,21,21,21,21,21,21,21,21,21,21,21,21,21,08,08
08,08,21,21,21,21,21,21,21,21,21,21,21,21,21,21,21,21,21,21,21,21,21,08,08
08,08,21,00,00,00,21,21,21,21,21,21,21,21,21,21,21,21,21,21,21,21,21,08,08
08,08,21,21,21,21,21,21,21,21,21,21,21,21,21,21,21,21,21,21,21,21,21,08,08
08,08,21,21,21,21,21,00,00,00,21,21,21,21,21,21,21,21,21,21,21,21,21,08,08
08,08,21,21,21,21,21,21,21,21,21,21,21,21,21,21,21,21,21,21,00,00,00,08,08
08,08,21,21,21,21,21,21,21,21,21,21,21,21,21,21,21,21,21,21,21,21,21,08,08
08,08,21,21,21,21,21,21,21,21,21,00,00,00,21,21,21,21,21,21,21,21,21,08,08
08,08,21,21,21,21,21,21,21,21,21,21,21,21,21,21,21,21,21,21,21,21,21,08,08
08,08,21,21,21,21,21,21,21,21,21,21,21,21,21,21,21,21,21,21,21,21,21,08,08
08,08,21,21,21,21,21,21,21,21,21,21,21,21,21,21,21,21,21,21,21,21,21,08,08
08,08,21,21,21,21,21,21,00,00,00,21,21,21,21,21,21,21,21,21,21,21,21,08,08
08,08,21,21,21,21,21,21,21,21,21,21,21,21,21,21,21,21,21,21,21,21,21,08,08
08,08,21,21,21,21,21,21,21,21,21,21,21,21,21,21,21,21,21,21,21,21,21,08,08
08,08,21,21,21,21,21,21,21,21,21,21,00,00,00,21,21,21,21,21,21,21,21,08,08
08,08,21,21,21,21,21,21,21,21,21,21,21,21,21,21,21,21,21,21,21,21,21,08,08
08,08,21,21,21,21,21,21,21,21,21,21,21,21,21,21,21,21,21,21,21,21,21,08,08
08,08,21,21,21,21,21,21,21,21,21,21,21,21,21,21,21,21,21,21,21,21,21,08,08
08,08,09,09,09,09,09,09,21,21,21,09,09,09,09,09,09,09,09,09,09,09,09,08,08