00,00,00,00,21,21,21,21,00,00,00,00,00,00,00,00,00,00,00,00,00,00,00,00,00
00,24,21,21,21,21,21,21,21,21,25,25,25,21,21,21,21,21,21,21,21,25,25,26,00
00,24,21,21,21,21,21,21,21,21,21,21,21,21,21,21,21,21,21,21,21,21,21,26,00
00,24,21,21,21,21,21,21,21,21,21,21,21,21,21,21,21,21,21,21,21,21,21,26,00
00,24,21,21,00,00,21,21,21,21,21,21,21,21,21,21,21,21,21,21,21,21,21,26,00
00,24,21,21,25,25,21,21,00,00,00,00,00,00,21,21,21,21,23,23,21,21,21,26,00
00,24,21,21,21,21,21,21,00,00,00,00,00,00,21,21,21,00,00,00,21,21,21,26,00
00,24,21,21,21,21,21,21,21,21,21,21,21,21,21,21,21,21,25,25,21,21,21,26,00
00,24,21,21,23,23,23,23,21,21,21,21,21,21,21,21,21,21,21,21,21,21,21,26,00
00,24,21,26,00,00,00,00,24,21,21,21,23,21,21,21,21,21,21,21,21,21,21,26,00
00,24,21,26,00,00,00,00,24,21,21,21,00,00,00,21,21,21,21,21,21,21,21,26,00
00,24,21,26,00,00,00,00,24,21,21,21,21,21,21,21,21,21,21,21,21,21,21,26,00
00,24,21,26,00,00,00,00,24,21,21,21,21,21,21,21,21,21,21,23,21,21,21,26,00
00,24,21,21,25,25,25,25,21,21,21,21,21,21,21,21,21,00,00,00,21,21,21,26,00
00,24,21,21,21,21,21,21,21,21,21,21,21,21,21,21,21,25,25,25,21,21,21,26,00
00,24,21,21,21,21,21,21,21,21,21,21,00,00,00,21,21,21,21,21,21,21,21,26,00
00,24,21,21,21,21,21,21,21,21,21,21,00,00,00,21,21,21,21,21,21,21,21,26,00
00,24,21,21,21,21,21,21,21,21,21,21,00,00,00,21,21,21,21,21,21,21,21,26,00
00,24,21,21,21,21,21,21,21,21,21,21,00,00,00,23,23,23,23,23,23,23,23,26,00
00,00,00,00,21,21,21,21,00,00,00,00,00,00,00,00,00,00,00,00,00,00,00,00,00

1,1,1,1,0,0,0,0,1,1,1,1,1,1,1,1,1,1,1,1,1,1,1,1,1
1,2,0,0,0,0,0,0,0,0,2,2,2,0,0,0,0,0,0,0,0,2,2,2,1
1,2,0,0,0,0,0,0,0,0,0,0,0,0,0,0,0,0,0,0,0,0,0,2,1
1,2,0,0,0,0,0,0,0,0,0,0,0,0,0,0,0,0,0,0,0,0,0,2,1
1,2,0,0,1,1,0,0,0,0,0,0,0,0,0,0,0,0,0,0,0,0,0,2,1
1,2,0,0,2,2,0,0,1,1,1,1,1,1,0,0,0,0,2,2,0,0,0,2,1
1,2,0,0,0,0,0,0,1,1,1,1,1,1,0,0,0,1,1,1,0,0,0,2,1
1,2,0,0,0,0,0,0,0,0,0,0,0,0,0,0,0,0,2,2,0,0,0,2,1
1,2,0,0,2,2,2,2,0,0,0,0,0,0,0,0,0,0,0,0,0,0,0,2,1
1,2,0,2,1,1,1,1,2,0,0,0,2,0,0,0,0,0,0,0,0,0,0,2,1
1,2,0,2,1,1,1,1,2,0,0,0,1,1,1,0,0,0,0,0,0,0,0,2,1
1,2,0,2,1,1,1,1,2,0,0,0,0,0,0,0,0,0,0,0,0,0,0,2,1
1,2,0,2,1,1,1,1,2,0,0,0,0,0,0,0,0,0,0,2,0,0,0,2,1
1,2,0,0,2,2,2,2,0,0,0,0,0,0,0,0,0,1,1,1,0,0,0,2,1
1,2,0,0,0,0,0,0,0,0,0,0,0,0,0,0,0,2,2,2,0,0,0,2,1
1,2,0,0,0,0,0,0,0,0,0,0,1,1,1,0,0,0,0,0,0,0,0,2,1
1,2,0,0,0,0,0,0,0,0,0,0,1,1,1,0,0,0,0,0,0,0,0,2,1
1,2,0,0,0,0,0,0,0,0,0,0,1,1,1,0,0,0,0,0,0,0,0,2,1
1,2,0,0,0,0,0,0,0,0,0,0,1,1,1,2,2,2,2,2,2,2,2,2,1
1,1,1,1,0,0,0,0,1,1,1,1,1,1,1,1,1,1,1,1,1,1,1,1,1